haplotype_1	AGATGGATACTTTCATCAGAGGGTGACACAGTGCCGATACTCCTCAAAGGACCTGCAGGGTATAGAGTTTATAGACTCTTATGTTTTCAATCAGGCTGAATATATCAGATTCAACAGCACTGTGGGGAAGTTTGTTGGATACACTGAGCATGGAGTGAAGAATGCAGAAGCCTGGAACAGTGATGCTGCGGGGCTGGCTGGAGAGCTAGGGGAGCTGGAGCGTTTCTGTAAGCATAACGCTGATCTCCACTACAGCAC
haplotype_2	AGATGGATACTTTCATCAGAGGGTGACACAGTGCCGATACTCCTCAAAGGACCTGCAGGGTATAGAGTTTATAGACTCTTATGTTTTCAATCAGGCTGAATATATCAGATTCAACAGCACTGTGGGGAAGTTTGTTGGATACACTGAGCTGGGAGTGAAGAATGCAGAAGCCTGGAACAAAGGTCCTGAGCTGGCTGGAGAGCTAGGGGTGCTGGAGCGTTACTGTAAGCATAACGCTGATATCGACTACAGCGC
haplotype_3	AGATGGATATTTTGAACAGGTTGTGAGACAGTGCCGATACTCCTCAAAGGACCTGCAGGGTATAGAGTTTATAGACTCTTATGTTTTCAATAAGGCTGAATATATCAGATTCAACAGCACTGTGGGGAAGTATGTTGGATACACTGAGCTGGGAGTGAAGAATGCAGAAGCCTGGAACAAAGGTCCTGAGCTGGCTGTAGAGCTAGGGGAGCTGGAGCGTTACTGTAAGCATAACGCTGATATCGACTACAGCGC
haplotype_4	AGATGGATATTTTGAACAGGTTGTGAGACAGTGCCGATACTCCTCAAAGGACCTGCAGGGTATAGAGTTTATAGACTCTTATGTTTTCAATAAGGCTGAATATATCAGATTCAACAGCACTGTGGGGAAGTATGTTGGATACACTGAGTATGGAGTGAAGAATGCAGAAGCCTGGAACAAAGGTCCTGAGCTGGCTAGAGCGCTAGGGGAGCTGGAGCGTTACTGTAAGTGTAACGCTCCTATCTACTACAGCGC
haplotype_5	AGATGGATATTTTGAACAGGTTGTGAGACAGTGCCGATACTCCTCAAAGGACCTGCAGGGTATAGAGTTTATAGACTCTTATGTTTTCAATAAGGCTGAATATATCAGATTCAACAGCACTGTGGGGAAGTATGTTGGATACACTGAGTATGGAGTGAAGAATGCAGAAGCCTGGAACAAAGGTCCTGAGCTGGCTAGAGCGCTAGGGGAGCTGGAGCGTTACTGTAAGTTTAACGCTCCTATCTACTACAGCGC
haplotype_6	AGATGGATATTTTGAACAGGTTGTGAGACAGTGCCGATACTCCTCAAAGGACCTGCAGGGTATAGAGTTTATAGACTCTTATGTTTTCAATAAGGCTGAATATATCAGATTCAACAGCACTGTGGGGAAGTATGTTGGATACACTGAGTATGGAGTGAAGAATGCAGAAGCCTGGAACAAAGGTCCTGAGCTGGCTGTAGAGCTAGGGGAGCTGGAGCGTTACTGTAAGCATAACGCTGATATCGACTACAGCGC
haplotype_7	AGATGGATATTTTGAACAGGTTGTGAGACAGTGCCGATACTCCTCAAAGGACCTGCAGGGTATAGAGTTTATAGACTCTTATGTTTTCAATAAGGCTGAATATGTCAGATTCAACAGCACTGTGGGGAAGTATGTTGGATACACTGAGCTGGGAGTGAAGAATGCAGAAGCCTGGAACAAAGGTCCTGAGCTGGCTGTAGAGCTAGGGGAGCTGGAGCGTTTCTGTAAGCATAACGCTGCTATCTACTACAGTGC
haplotype_8	AGATGGATATTTTGAACAGGTTGTGAGACAGTGCCGATTCTCCTCAAAGGACCTGCAGGGTACAGAGTTTATAGACTCTTATGTTTTCAATAAGGCTGAATATGTCAGATTCAACAGCACTGTGGGGAAGTATGTTGGATACACTGAGCTGGGAGTGAAGAATGCAGAAGCCTGGAACAAAGGTCCTGAGCTGGCTGGAGAGCTAGGGGAGCTGGAGCGTTTCTGTAAGCATAACGCGCCTATCGACTACAGCGC
haplotype_9	AGATGGATATTTTGAACAGGTTGTGAGACAGTGCCGATTCTCCTCAAAGGACCTGCAGGGTACAGAGTTTATAGACTCTTATGTTTTCAATAAGGCTGAATATGTCAGATTCAACAGCACTGTGGGGAAGTATGTTGGATACACTGAGCTGGGAGTGAAGAATGCAGAAGCCTGGAACAAAGGTCCTGAGCTGGCTGGAGAGCTAGGGGAGCTGGAGCGTTTCTGTAAGCATAACGCTCCTATCGACTACAGCGC
haplotype_10	AGATGGATATTTTGAACAGGTTGTGAGACAGTGCCGATTCTCCTCAAAGGACCTGCAGGGTACAGAGTTTATAGACTCTTATGTTTTCAATAAGGCTGAATATGTCAGATTCAACAGCACTGTGGGGAAGTATGTTGGATACACTGAGCTGGGAGTGAAGAATGCAGAAGCCTGGAACAAAGGTCCTGAGCTGGCTGGAGAGCTAGGGGAGCTGGAGCGTTTCTGTAGGCATAACGCTCCTATCGACTACAGCGC
haplotype_11	AGATGGATATTTTGAACAGGTTGTGAGACAGTGCCGATTCTCCTCAAAGGACCTGCAGGGTACAGAGTTTATAGACTCTTATGTTTTCAATAAGGCTGAATATGTCAGATTCAACAGCACTGTGGGGAAGTATGTTGGATACACTGAGCTGGGAGTGAAGAATGCAGAAGCCTGGAACAAAGGTCCTGAGCTGGCTGTAGAGCTAGGGGAGCTGGAGCGTTACTGTAAGCATAACGCTGATATCGACTACAGCGC
haplotype_12	AGATGGATATTTTGAACAGGTTGTGAGACAGTGCCGATTCTCCTCAAAGGACCTGCAGGGTACAGAGTTTATAGACTCTTATGTTTTCAATAAGGCTGAATATGTCAGATTCAACAGCACTGTGGGGAAGTATGTTGGATACACTGAGCTGGGAGTGAAGAATGCAGAAGCCTGGAACAAAGGTCCTGAGCTGGCTGTAGAGCTAGGGGAGCTGGAGCGTTTCTGTAAGCAAAACGCTCCTATCGACTACAGCGC
haplotype_13	AGATGGATATTTTGAACAGGTTGTGAGTCAGTGCCGATTCTCCTCAAAGGACCTGCAGGGTACAGAGTTTATAGACTCTTATGTTTTCAATAAGGCTGAATATGTCAGATTCAACAGCACTGTGGGGAAGTATGTTGGATACACTGAGCTGGGAGTGAAGAATGCAGAAGCCTGGAACAAAGGTCCTGAGCTGGCTGGAGAGCTAGGGGAGCTGGAGCGTTTCTGTAAGCATAACGCTCCTATCGACTACAGCGC
haplotype_14	AGATGGATATTTTGAACAGGTTGTGAGTCAGTGCCGATTCTCCTCAAAGGACCTGCAGGGTACAGAGTTTATAGACTCTTATGTTTTCAATAAGGCTGAATATGTCAGATTCAACAGCACTGTGGGGAAGTATGTTGGATACACTGAGCTGGGAGTGAAGAATGCAGAAGCCTGGAACAAAGGTCCTGAGCTGGCTGTAGAGCTAGGGGAGCTGGAGCGTTTCTGTAAGCAAAACGCGCCTATCGACTACAGCGC
haplotype_15	AGATGGATATTTTGAACAGGTTGTGAGTCAGTGCCGATTCTCCTCAAAGGACCTGCAGGGTACAGAGTTTATAGACTCTTATGTTTTCAATAAGGCTGAATATGTCAGATTCAACAGCACTGTGGGGAAGTATGTTGGATACACTGAGCTGGGAGTGAAGAATGCAGAAGCCTGGAACAAAGGTCCTGAGCTGGCTGTAGAGCTAGGGGAGCTGGAGCGTTTCTGTAAGCAAAACGCTCCTATCGACTACAGCGC
haplotype_16	AGATGGATATTTTTATCAGAGGGTGTCAGAGTGCCGATACTCCTCAAAGGACCTGCAGGGTATAGAGTTTATAGACTCTTATGTTTTCAATAAGGCTGAATATGTCAGATTCAACAGCACTGTGGGGAAGTATGTTGGATACACTGAGTATGGAGTGAAGAATGCAGAAGCCTGGAACAAAGGTCCTGAGCTGGCTGGAGAGCTAGGGGAGCTGGAGCGTGTCTGTAAGCATAACGCTCCTATCGACTACAGCGC
haplotype_17	AGATGGATATTTTTATCAGAGGGTGTCAGAGTGCCGATACTCCTCAAAGGACCTGCAGGGTATAGAGTTTATAGACTCTTATGTTTTCAATAAGGCTGAATATGTCAGATTCAACAGCACTGTGGGGAAGTATGTTGGATACACTGAGTATGGAGTGAAGAATGCAGAAGCCTGGAACAAAGGTCCTGAGCTGGCTGGAGAGCTAGGGGAGCTGGAGCGTTTCTGTAAGCATAACGCTCCTATCGACTACAGCGC
haplotype_18	AGATGGATATTTTTATCAGAGGGTGTCAGAGTGCCGATACTCCTCAAAGGACCTGCAGGGTATAGAGTTTATAGACTCTTATGTTTTCAATCAGGCTGAAAATATCAGATTCAACAGCACTGTGGGGAAGTTTGTTGGATACACTGAGCTGGGAGTGAAGAATGCAGAAGCCTGGAACAAAGGTCCTGAGCTGGCTGGAGAGCTAGGGGAGCTGGAGCGTTTCTGTAAGCATAACGCTGATCTCCACTACAGCAC
haplotype_19	AGATGGATATTTTTATCATATGATGAGACAGTGCCGATACTCCTCAAAGGACCTGCAGGGTATAGAGTTGATTACCTCGTATGTTTTCAATCAGGCTGAAAATATCAGATTCAACAGCACTGTGGGGAAGTTTGTTGGATACACTGAGCTGGGAGTGAAGAATGCAGAAGCCTGGAACAAAGGTCCTGAGCTGGCTGGAGAGCTAGGGGTGCTGGAGCGTTTCTGTAAGCATAACGCTGATCTCCACTACAGCAC
haplotype_20	AGATGGATATTTTTATCATATGATGAGACAGTGCCGATACTCCTCAAAGGACCTGCAGGGTATAGAGTTGATTACCTCGTATGTTTTCAATCAGGCTGAATATATCAGATTCAACAGCACTGTGGGGAAGTATGTTGGATACACTGAGTATGGAGTGAAGAATGCAGAAGCCTGGAACAAAGGTCCTGAGCTGGCTGGAGAGCTAGGGGAGCTGGAGCGTGTCTGTAAGCATAACGCTCCTATCTACTACAGCGC
haplotype_21	AGATGGATATTTTTTCAGGTTGTGAGACAGTGCCGATACTCCTCAAAGGACCTGCAGGGTATAGAGTTTATACACTCTTATGTTTTCAATCAGGCTGAAAATATCAGATTCAACAGCACTGTGGGGAAGTATGTTGGATACACTGAGCTGGGAGTGAAGAATGCAGAAGCCTGGAACAAAGGTCCTGAGCTGGCTGTAGAGCTAGGGGAGCTGGAGCGTTACTGTAAGCATAACGCTGATATCGACTACAGCGC
haplotype_22	AGATGGATATTTTTTTCAGGTTGTGAGACAGTGCCGATACTCCTCAAAGGACCTGCAGGGTATAGAGTTTATACACTCTTATGTTTTCAATCAGGCTGAAAATATCAGATTCAACAGCACTGTGGGGAAGTATGTTGGATACACTGAGCTGGGAGTGAAGAATGCAGAAGCCTGGAACAAAGGTCCTGAGCTGGCTGTAGAGCTAGGGGAGCTGGAGCGTTACTGTAAGCATAACGCTGATATCGACTACAGCGC
haplotype_23	AGCTGGATACTTTCATCAGAGGGTGACACAGTGCCGATACTCCTCAAAGGACCTGCAGGGTATAGAGTTTATAGACTCTTATGTTTTCAATCAGGCTGAATATATCAGATTCAACAGCACTGTGGGGAAGTTTGTTGGATACACTGAGCTGGGAGTGAAGAATGCAGAAGCCTGGAACAAAGGTCCTGAGCTGGCTGGAGAGCTAGGGGTGCTGGAGCGTTACTGTAAGCATAACGCTGATATCGACTACAGCGC
haplotype_24	AGCTGGATATTTTGAACAGGTTGTGAGACAGTGCCGATTCTCCTCAAAGGACCTGCAGGGTACAGAGTTTATAGACTCTTATGTTTTCAATAAGGCTGAATATGTCAGATTCAACAGCACTGTGGGGAAGTATGTTGGATACACTGAGCTGGGAGTGAAGAATGCAGAAGCCTGGAACAAAGGTCCTGAGCTGGCTGGAGAGCTAGGGGAGCTGGAGCGTTTCTGTAAGCATAACGCTCCTATCGACTACAGCGC
haplotype_25	AGCTGGATATTTTGAACAGGTTGTGAGTCAGTGCCGATTCTCCTCAAAGGACCTGCAGGGTACAGAGTTTATAGACTCTTATGTTTTCAATAAGGCTGAATATGTCAGATTCAACAGCACTGTGGGGAAGTATGTTGGATACACTGAGCTGGGAGTGAAGAATGCAGAAGCCTGGAACAAAGGTCCTGAGCTGGCTGTAGAGCTAGGGGAGCTGGAGCGTTTCTGTAAGCAAAACGCTCCTATCGACTACAGCGC
